Cleanup use of repositories for resolving plugin dependencies by using a LinkedHashSet to avoid duplicated repository defs (although two defs pointing to the same URL but with different id's will still look like two repos).

git-svn-id: https://svn.apache.org/repos/asf/maven/components/trunk@615004 13f79535-47bb-0310-9956-ffa450edef68

+    public DefaultMavenExecutionRequest()
+    {
+        // default constructor.
+    }
+
+    public DefaultMavenExecutionRequest( MavenExecutionRequest original )
+    {
+        localRepository = original.getLocalRepository();
+        localRepositoryPath = original.getLocalRepositoryPath();
+        offline = original.isOffline();
+        interactiveMode = original.isInteractiveMode();
+        proxies = original.getProxies();
+        servers = original.getServers();
+        mirrors = original.getMirrors();
+        profiles = original.getProfiles();
+        pluginGroups = original.getPluginGroups();
+        usePluginUpdateOverride = original.isUsePluginUpdateOverride();
+        isProjectPresent = original.isProjectPresent();
+        userSettingsFile = original.getUserSettingsFile();
+        globalSettingsFile = original.getGlobalSettingsFile();
+        basedir = new File( original.getBaseDirectory() );
+        goals = original.getGoals();
+        useReactor = original.useReactor();
+        recursive = original.isRecursive();
+        pom = original.getPom();
+        reactorFailureBehavior = original.getReactorFailureBehavior();
+        properties = original.getProperties();
+        startTime = original.getStartTime();
+        showErrors = original.isShowErrors();
+        eventMonitors = original.getEventMonitors();
+        activeProfiles = original.getActiveProfiles();
+        inactiveProfiles = original.getInactiveProfiles();
+        transferListener = original.getTransferListener();
+        loggingLevel = original.getLoggingLevel();
+        globalChecksumPolicy = original.getGlobalChecksumPolicy();
+        updateSnapshots = original.isUpdateSnapshots();
+        profileManager = original.getProfileManager();
+        remoteRepositories = original.getRemoteRepositories();
+        noSnapshotUpdates = original.isNoSnapshotUpdates();
+        realmManager = original.getRealmManager();
+    }
+
